6 7
9 8
108
4 4 1 1 1 1 1 1
4 4 1 0 0 0 0 1
1 1 1 2 1 1 0 1
1 0 2 3 0 1 0 1
1 0 1 3 0 2 0 1
1 0 0 3 2 1 0 1
1 1 1 3 0 1 0 1
4 4 1 1 0 0 0 1
4 4 1 1 1 1 1 1