2 4
8 9
72
4 1 1 1 1 1 1 1 4
4 1 0 0 3 3 3 1 4
1 1 0 0 0 1 1 1 1
1 1 1 2 0 0 0 0 1
1 0 0 0 1 2 1 0 1
1 0 2 0 1 0 0 0 1
1 0 0 0 1 1 1 1 1
1 1 1 1 1 4 4 4 4