5 5
9 9
50
4 4 1 1 1 1 1 4 4
4 1 0 0 0 0 0 1 4
1 3 0 1 0 1 0 3 1
1 0 0 1 0 1 0 0 1
1 0 2 0 0 0 2 0 1
1 0 1 0 0 0 1 0 1
1 0 0 1 1 1 0 0 1
4 1 0 0 0 0 0 1 4
4 4 1 1 1 1 1 4 4

