3 6
7 7
35
4 4 1 1 1 1 1
4 4 1 0 0 0 1
1 1 1 2 2 0 1
1 0 0 0 1 1 1
1 0 0 0 0 0 1
1 0 3 0 3 0 1
1 1 1 1 1 1 1